1653997881,0,0,0,0.00,0,0,0,0
1653997882,0,0,0,0.00,0,0,0,0
1653997883,8,1,128,312.00,47,81,16,0
1653997884,8,1,2168,312.00,1553,615,271,0
1653997886,8,1,2152,311.52,1495,657,269,0
1653997887,8,1,2144,311.89,1481,663,268,0
1653997888,8,1,2112,312.29,1524,588,264,0
1653997889,8,1,2176,312.00,1473,703,272,0
1653997890,8,1,2136,312.00,1504,632,267,0
1653997891,8,1,2136,312.00,1526,610,267,0
1653997892,8,1,2144,311.87,1439,705,268,0
