1624528451,16,1,2704,418.27,2362,342,169,0
1624528452,16,1,832,412.59,735,97,52,0
1624528550,16,1,2368,433.31,2092,276,148,0
1624528551,16,1,2736,411.76,2405,331,171,0
1624528675,16,1,2256,429.30,1982,274,141,0
1624528747,12,2,2028,324.11,468,1560,169,0
1624528748,12,2,132,323.77,93,39,11,0
1624601450,16,1,2528,355.85,2189,339,158,0
1624601451,16,1,1616,356.86,1377,239,101,0
1624601468,16,1,2416,430.02,2103,313,151,0
1624601469,16,1,1568,417.95,1367,201,98,0
